1111111
1C0E0P1
1110001
1111111