1111111111111
1E010C00C00P1
1000011111001
1C0011000C0C1
1111111111111