1111111111111
1000000000001
1011111111101
10100C00C0101
1010011110101
101E110P0C101
1011111111101
1000000000001
1111111111111