1111111111111111111111111111111111
1E100C000000001C00000C0000000000C1
1010010100100010101001000000011101
1000010010101000001001000100011101
1P0000000C00C0000000000010000000C1
1111111111111111111111111111111111