111111111111111111111111111
1C00000000000000000000000C1
111000001111001111100000001
1E1000011111001111110000001
101000111111001110111000001
101001111111000110111000001
10100000111100001C111000001
101000001111000000111000001
101010001111000000111000001
101010001111000000111001101
101010001111001111111001001
100010001111000111111001011
111110001111000011111001001
100000001111000000000001101
1000000011110000000000010P1
100000001111000000000001011
1C00000000000000000000010C1
111111111111111111111111111