1111111111111111111111111111111111
1E1000C11100C111110000C00000000001
10100C1C1C0011111C0100100000001011
10100000C1000110110100100000001011
100000001C000C0C1C0000000100000001
10100100C1000001110001000000010101
101001001C000C111C0000100000001011
10000000C10000C1C10000000100000001
101001001C000000010100100000001011
10100100000010100010010000000P0101
100000000C00C0000000000010000000C1
1111111111111111111111111111111111