11111111111111111111111111111111111111111111111111111111111111111111111111111111
10P0C0E00000000000C00000C000000000000000000000000C00000C000000000000000000000001
100000000000000000C00000C000000000000000000000000C00000C000000000000000000000001
100000000000000000C00000C000000000000000000000000C00000C000000000000000000000001
100000000000000000C00000C000000000000000000000000C00000C000000000000000000000001
100000000000000000C00000C000000000000C00000000000C00000C000000000000000000000001
100000000000000000C00000C000000000000000000000000C00000C000000000000000000000001
100000000100000000C00000C000000000000000000000000C00000C000000000000000000000001
100000000000000000C00000C000000000000000000000000C00000C000000000000000000000001
100000000000000000C00000C000000000000000000000000C00000C000000000000000000000001
100000000000000000C00000C000000000000000000000000C00000C000000000000000000000001
100000000000000000C00000C000000000000000000000000C00000C000000000000000000000001
100000000000000000C00000C000000000000C00000000000C00000C000000000000000000000001
100000000000000000C00000C000000000000000000000000C00000C000000000000000000000001
100000000100000000C00000C000000000000000000000000C00000C000000000000000000000001
100000000000000000C00000C000000000000000000000000C00000C000000000000000000000001
100000000000000000C00000C000000000000000000000000C00000C000000000000000000000001
100000000000000000C00000C000000000000000000000000C00000C000000000000000000000001
100000000000000000C00000C000000000000000000000000C00000C000000000000000000000001
100000000000000000C00000C000000000000000000000000C00000C000000000000000000000001
100000000000000000C00000C000000000000000000000000C00000C000000000000100000000001
100000000000000000C00000C000000001100000000000000C00000C000000000000000000000001
100000000000000000C00000C000000000000000000000000C00000C000000000000000000000001
100000000000000000C00000C000000000000000000000000C00000C000000000000000000000001
100000000000000000C00000C000000000000000000000000C00000C000000000000000000000001
100000000100000000C00000C000000000000000000000000C00000C000000000000000000000001
100000000000000000C00000C000000000000000000000000C00000C000000000000000000000001
100000000000000000C00000C000000000000000000000000C00000C000000000000000000000001
100000000000000000C00000C000000000000000000000000C00000C000000000000000000000001
100000000000000000C00000C000000000000000000000000C00000C000000000000000000000001
100000000000000000C00000C000000000000000000000000C00000C000000000000000000000001
100000000000000000C00000C000000000000000000000000C00000C000000000000000000000001
100000000000000000C00000C000000000000000000000000C00000C000000000000000000000001
100000000000000000C00000C000000000000000000000000C00000C000000000000000000000001
100000000000000000C00000C000000000000000000000000C00000C000000000000000000000001
100000000000000000C00000C000000000000000000000000C00000C000000000000000000000001
100000000000000000C00000C000000000000000000000000C00000C000000000000000000000001
100000000000000000C00000C000000000000000000000000C00000C000000000000000000000001
100000000000000000C00000C000000000000000000000000C00000C000000000000000000000001
100000000000000000C00000C000000000000000000000000C00000C000000000000000000000001
100000000000000000C00000C000000000000000000000000C00000C000000000000000000000001
100000000000000000C00000C000000000000000000000000C00000C000000000000000000000001
100000000000000000C00000C000000000000000000000000C00000C000000000000000000000001
11111111111111111111111111111111111111111111111111111111111111111111111111111111