1111111111111
1E010C00C00P1
1000011111001
100011C1000C1
1111111111111