1111111111111111111
1C10000000000000001
1010111111111111101
1010100000000000101
1010101111111110101
1010101000000010101
1010101011111010101
1010101010P01010101
101010101E101010101
1010101011101010101
1010101000001010101
1010101111111010101
1010100000000010101
1010111111111110101
1010000000000000101
1011111111111111101
1000000000000000001
1111111111111111111