11111111
1E10P0C1
11000001
11111111