1111111111111
1E010C00C00P1
10000111110000C01
100011C0000C000C1
1111111111111