11111111111111111111111111111111111111111111111111111111111111111111111111111111
10P0C0000000000000C00000C000000000000000000000000C00000C000000000000000000000001
100000000000000000C00000C000000000000000000000000C00000C000000000000000000000001
100000000000000000C00000C000000000000000000000000C00000C000000000000000000000001
100000000000000000C00000C000000000000000000000000C00000C000000000000000000000001
100000000000000000C00000C000000000000C00000000000C00000C000000000000000000000001
100000000000000000C00000C000000000001111100000000C00000C000000000000000000000001
100000000100000000C00000C000000000001000100000000C00000C000000000000000000000001
100000000000000000C00000C000000000001010100000000C00000C000000000000000000000001
100000000000000000C00000C00000000001E010100000000C00000C000000000000000000000001
100000000000000000C00000C000000000001010000000000C00000C000000000000000000000001
100000000000000000C00000C000000000000000000000000C00000C000000000000000000000001
100000000000000000C00000C000000000000C00000000000C00000C000000000000000000000001
100000000000000000C00000C000000000000000000000000C00000C000000000000000000000001
100000000100000000C00000C000000000000000000000000C00000C000000000000000000000001
100000000000000000C00000C000000000000000000000000C00000C000000000000000000000001
100000000000000000C00000C000000000000000000000000C00000C000000000000000000000001
100000000000000000C00000C000000000000000000000000C00000C000000000000000000000001
100000000000000000C00000C000000000000000000000000C00000C000000000000000000000001
100000000000000000C00000C000000000000000000000000C00000C000000000000000000000001
100000000000000000C00000C000000000000000000000000C00000C000000000000100000000001
100000000000000000C00000C000000001100000000000000C00000C000000000000000000000001
100000000000000000C00000C000000000000000000000000C00000C000000000000000000000001
100000000000000000C00000C000000000000000000000000C00000C000000000000000000000001
100000000000000000C00000C000000000000000000000000C00000C000000000000000000000001
100000000100000000C00000C000000000000000000000000C00000C000000000000000000000001
100000000000000000C00000C000000000000000000000000C00000C000000000000000000000001
100000000000000000C00000C000000000000000000000000C00000C000000000000000000000001
100000000000000000C00000C000000000000000000000000C00000C000000000000000000000001
100000000000000000C00000C000000000000000000000000C00000C000000000000000000000001
100000000000000000C00000C000000000000000000000000C00000C000000000000000000000001
100000000000000000C00000C000000000000000000000000C00000C000000000000000000000001
100000000000000000C00000C000000000000000000000000C00000C000000000000000000000001
100000000000000000C00000C000000000000000000000000C00000C000000000000000000000001
100000000000000000C00000C000000000000000000000000C00000C000000000000000000000001
100000000000000000C00000C000000000000000000000000C00000C000000000000000000000001
100000000000000000C00000C000000000000000000000000C00000C000000000000000000000001
100000000000000000C00000C000000000000000000000000C00000C000000000000000000000001
100000000000000000C00000C000000000000000000000000C00000C000000000000000000000001
100000000000000000C00000C000000000000000000000000C00000C000000000000000000000001
100000000000000000C00000C000000000000000000000000C00000C000000000000000000000001
100000000000000000C00000C000000000000000000000000C00000C000000000000000000000001
100000000000000000C00000C000000000000000000000000C00000C000000000000000000000001
100000000000000000C00000C000000000000000000000000C00000C000000000000000000000001
11111111111111111111111111111111111111111111111111111111111111111111111111111111